111111111111111111111
100000000000000010001
102000000000000010301
111110001111111110001
100000001000000010001
100000000000000010001
100001111111111110001
100000000000000000001
100000000000000000001
111111111111111111111